53 63 63 14 53 14 14 14 14 63 63 63 63 63 63 63 63 63 63 63 63 63 63 63 63 63 63 63 63 63 63 63 63 63 63 63 63 63 63 63 63 63 63 63 63 63 63 63 63 63 63 63 63 63 63 63 63 63 63 63 63 63 63 63 63 63 63 63 63 63 63 63 63 63 63 63 63 63 63 63 63 63 63 63 63 63 63 53 53 53 63 63 63 63 63 63 63 63 63 53 
63 63 63 63 63 63 63 53 14 63 63 63 63 63 14 63 63 63 63 63 63 63 63 63 63 63 63 63 63 63 63 63 63 63 63 63 63 63 63 63 63 63 53 63 53 63 51 51 51 51 51 51 51 51 63 63 63 63 63 63 63 63 63 63 63 63 63 63 63 63 63 63 63 63 63 63 63 63 63 63 63 51 51 51 51 63 63 63 63 63 63 63 63 63 63 63 63 63 63 63 
53 53 14 53 14 63 63 63 63 63 53 14 53 14 14 14 14 11 14 14 14 53 14 63 63 63 53 53 53 53 53 53 53 53 63 63 51 51 51 51 51 51 51 51 51 51 51 51 51 51 51 51 51 51 51 51 51 63 63 63 63 53 63 53 63 63 63 63 53 63 63 63 63 63 63 53 63 6 53 53 51 51 51 51 45 51 51 45 63 63 63 45 45 63 63 63 63 63 63 63 
53 53 53 53 14 53 53 14 53 14 53 14 53 53 53 53 14 11 53 53 14 14 53 63 14 14 14 53 63 63 53 53 53 51 51 51 51 51 51 51 51 51 51 51 53 53 51 51 53 53 53 51 51 53 53 53 53 53 53 53 53 53 45 45 53 53 63 63 63 63 53 53 53 53 53 6 6 6 6 53 53 45 51 51 51 53 45 45 45 63 45 45 45 45 63 63 63 53 63 63 
14 14 14 14 14 14 53 14 53 53 53 14 14 53 14 53 14 11 53 53 28 28 53 53 53 53 53 53 53 53 53 53 51 51 51 51 51 51 51 51 53 53 53 53 53 53 53 53 51 51 51 51 51 51 51 51 51 53 53 53 53 45 45 45 45 53 53 53 53 53 53 53 53 53 6 6 53 53 53 53 53 53 51 51 51 51 45 45 45 45 45 45 45 45 45 45 63 63 63 63 
53 53 53 53 53 53 53 14 14 14 14 14 14 53 53 53 53 11 28 53 53 28 28 53 53 53 53 53 53 53 53 53 51 51 51 51 2 53 53 37 37 37 37 53 53 53 53 53 53 53 53 53 53 51 51 51 51 51 6 53 53 45 45 45 45 45 53 45 53 53 53 53 6 6 6 53 53 53 53 53 53 53 53 53 53 53 51 51 45 45 45 45 45 45 45 45 45 63 63 53 
53 53 53 53 53 53 53 14 14 14 14 22 14 53 53 53 53 53 11 53 28 28 28 28 28 53 53 53 53 53 53 53 51 51 51 53 53 53 53 53 53 53 53 53 53 53 53 53 53 53 53 53 53 53 53 53 53 51 51 51 51 51 51 45 45 53 53 53 53 53 53 53 6 6 53 53 53 53 53 53 53 53 53 53 53 53 53 51 53 53 53 45 45 45 45 45 45 45 63 63 
53 53 53 53 45 45 53 14 53 53 51 51 53 53 53 53 53 53 11 53 53 16 16 28 14 14 53 53 53 53 53 53 51 51 51 51 53 53 6 53 53 53 53 53 53 53 53 53 32 41 41 53 53 53 53 53 53 51 53 51 51 51 51 51 45 45 45 53 53 53 53 6 6 53 53 53 53 53 53 53 53 15 15 15 15 15 15 15 15 15 15 15 15 45 45 45 45 45 45 63 
53 53 53 53 53 45 45 45 53 53 51 53 53 22 53 53 53 53 53 11 53 53 16 16 14 28 28 53 53 53 53 53 51 51 51 51 53 53 53 6 6 53 53 53 53 53 53 53 53 53 53 32 32 53 53 53 53 51 51 53 53 53 51 51 53 53 53 53 53 53 53 6 53 53 53 53 53 53 53 53 15 15 15 15 15 15 51 15 53 53 53 53 15 53 15 45 45 45 45 45 
54 54 54 53 53 53 45 45 45 53 45 45 53 53 22 53 53 53 53 11 53 53 28 14 28 53 28 53 53 53 53 51 51 53 51 53 53 53 53 53 53 6 6 53 53 53 53 53 53 53 53 53 53 53 53 54 54 54 54 54 54 54 54 54 53 53 53 53 53 53 53 53 53 53 53 53 53 53 53 53 53 53 53 53 53 53 53 53 15 15 15 15 15 15 53 53 53 53 45 45 
54 54 54 54 54 53 53 45 45 45 45 53 45 45 22 53 53 53 11 11 53 53 14 53 28 53 28 53 53 53 51 51 53 51 51 53 14 14 14 53 53 53 53 6 6 53 53 53 53 53 53 53 54 54 54 54 54 54 54 54 54 54 54 54 54 54 54 54 54 54 19 19 53 54 53 54 54 54 54 54 53 53 53 53 53 53 53 53 53 53 53 53 53 15 15 53 53 53 53 53 
54 54 54 54 54 54 53 53 45 45 45 45 45 45 53 22 53 53 11 53 53 14 53 53 53 53 53 53 53 53 51 51 53 51 51 53 53 53 53 14 14 53 53 53 6 6 53 53 53 53 54 54 54 54 54 54 54 54 54 54 54 53 53 53 53 54 54 54 54 54 19 19 54 54 54 54 54 54 54 54 53 53 53 53 53 53 53 53 53 53 53 53 53 53 53 53 53 53 53 53 
13 53 54 54 54 54 54 53 45 53 45 45 45 45 22 22 53 53 53 53 53 14 51 51 51 53 53 53 53 51 53 53 51 51 53 53 53 53 53 53 14 14 14 53 53 6 19 19 54 54 54 54 53 53 53 53 53 24 51 51 53 53 24 53 53 53 53 53 54 54 19 19 54 54 54 54 54 54 58 54 54 54 54 53 53 53 33 33 33 33 33 33 53 53 53 53 53 53 53 53 
13 53 53 53 54 54 54 53 53 53 45 53 45 45 45 45 53 53 53 53 53 14 51 53 53 53 53 16 53 51 53 51 51 53 53 53 51 53 38 38 38 53 53 53 53 19 19 19 54 54 53 53 53 53 53 53 53 51 22 22 22 22 22 22 22 51 53 53 53 53 19 19 54 54 53 54 54 54 58 58 58 54 54 54 54 54 54 54 53 53 53 33 33 53 53 53 53 53 53 53 
13 13 53 53 54 54 54 53 53 53 45 45 45 45 45 45 53 53 53 51 51 53 53 53 53 53 16 16 53 51 53 51 51 53 53 53 51 38 38 53 51 53 53 54 54 19 19 19 53 53 53 53 53 53 53 51 51 53 53 53 53 53 51 51 22 24 22 22 22 53 53 53 53 53 53 53 53 53 54 54 54 58 54 54 54 54 54 54 54 54 53 53 53 53 53 53 53 53 53 53 
3 13 53 53 54 54 54 54 53 53 53 45 45 45 45 53 53 53 53 51 53 53 53 53 53 16 16 16 53 51 51 14 53 53 53 53 51 53 53 51 51 54 54 54 54 19 19 19 53 53 53 53 53 53 51 51 53 53 53 53 53 2 51 24 24 22 53 53 24 47 47 51 53 22 22 53 53 53 53 53 53 53 53 54 54 54 54 54 54 54 54 54 54 54 53 53 53 53 54 54 
3 12 53 53 53 54 54 54 53 53 53 51 45 45 45 53 53 53 51 51 53 53 53 16 16 16 16 53 53 51 14 14 53 53 53 53 51 51 51 51 54 54 54 54 54 19 52 56 53 53 53 53 24 51 51 53 53 53 53 53 51 51 24 22 22 53 53 24 53 47 53 51 51 51 51 53 53 53 53 53 53 53 53 53 53 53 53 53 53 53 54 54 54 54 54 54 54 54 54 54 
3 12 13 53 53 54 54 54 53 53 53 51 45 45 45 45 53 53 51 53 53 16 16 16 16 53 53 53 51 51 14 14 53 53 53 53 53 54 54 54 54 54 53 53 53 53 52 52 53 53 53 53 51 51 53 24 24 24 51 51 51 24 24 22 53 53 53 53 53 53 53 22 22 45 45 45 53 53 53 22 22 45 45 45 53 53 53 53 53 13 13 53 23 53 54 54 58 58 54 54 
3 12 13 13 53 53 54 54 53 53 53 51 45 45 51 45 45 53 51 53 53 16 53 53 53 53 53 51 51 53 53 53 53 54 54 54 54 54 54 53 10 10 53 53 53 53 52 52 56 5 53 51 51 53 53 53 53 51 51 51 24 24 22 22 53 53 53 23 53 51 22 45 45 53 53 22 22 22 22 22 22 22 22 22 45 45 45 45 45 53 53 23 23 23 24 24 54 58 58 58 
3 12 12 13 53 53 54 54 53 53 53 22 45 45 45 45 45 45 51 16 16 53 53 53 53 51 51 51 53 53 53 54 54 54 54 54 54 53 53 53 10 10 53 45 45 53 52 52 56 53 53 51 53 24 53 53 51 51 24 53 24 24 22 24 24 24 53 23 23 22 45 45 53 45 45 45 53 53 53 3 3 53 3 22 22 22 53 53 53 13 13 53 53 23 24 24 23 53 54 54 
3 3 12 13 53 53 54 54 54 53 53 53 45 45 45 53 45 45 51 53 53 53 53 53 53 51 51 53 53 53 54 54 54 9 53 53 53 53 53 10 10 22 45 45 53 53 52 52 52 53 53 51 53 24 53 51 51 24 24 24 24 22 22 2 22 53 53 53 23 23 53 53 45 45 53 3 3 3 3 2 22 22 22 22 22 22 22 22 53 53 13 23 53 23 24 24 13 53 53 53 
3 3 12 53 13 53 54 54 54 53 53 53 45 53 45 45 45 53 51 53 53 53 53 53 51 51 53 53 53 54 54 53 9 9 28 28 53 53 53 10 22 45 45 53 53 53 52 53 52 53 53 51 53 24 53 51 53 24 24 24 24 22 22 22 22 22 53 45 23 23 23 53 3 3 3 3 3 53 53 53 53 53 22 22 22 53 53 22 22 53 23 23 24 23 23 24 13 13 53 53 
3 3 3 12 13 53 54 54 54 54 53 53 45 53 53 45 45 45 51 51 53 53 51 51 51 53 53 54 54 54 53 28 28 28 28 28 22 53 53 10 45 45 53 53 53 53 52 52 52 53 53 51 24 24 51 53 24 24 53 22 22 22 22 22 22 22 22 23 51 53 23 23 3 3 53 53 53 53 53 53 53 53 53 53 22 22 53 53 22 22 23 23 24 24 24 24 13 13 13 53 
3 3 3 12 13 13 53 54 53 54 53 53 53 45 45 45 45 45 10 51 51 51 51 53 53 54 54 54 54 28 28 9 9 28 28 22 22 22 53 53 10 22 22 53 24 53 52 52 52 53 53 24 24 51 53 53 24 18 18 18 18 18 22 22 22 22 22 23 22 53 3 23 53 53 53 53 53 53 53 53 53 53 53 53 53 53 53 53 24 14 24 24 24 24 53 24 13 13 13 13 
3 3 3 12 13 13 53 54 54 54 54 53 53 10 45 45 45 53 10 51 51 53 53 54 54 54 53 53 28 28 9 9 28 28 53 22 22 22 53 53 53 10 10 22 53 53 52 52 52 53 53 24 24 51 53 53 53 53 24 24 24 24 18 18 22 22 22 23 22 53 53 53 53 53 41 41 41 53 53 39 53 53 53 53 53 53 53 53 14 14 24 24 24 53 24 24 53 13 13 13 
3 3 3 12 12 13 13 54 58 54 54 10 10 10 10 10 53 53 53 53 53 53 54 54 54 53 9 28 9 9 9 28 53 53 53 22 22 22 22 53 10 10 10 10 22 53 52 52 56 53 24 24 51 51 53 53 53 53 53 53 24 24 53 24 18 22 22 22 22 53 53 41 41 41 53 3 53 53 53 39 39 53 53 53 53 53 53 53 14 14 24 24 24 53 24 53 53 53 13 13 
53 3 3 3 12 13 13 54 54 54 54 10 10 10 53 53 18 18 18 53 53 54 54 54 53 28 28 9 9 28 28 53 53 53 22 22 53 53 53 53 53 53 53 22 22 49 52 52 56 49 53 24 53 51 53 53 53 53 53 24 53 53 53 53 53 53 22 22 22 22 53 53 53 53 3 3 3 3 53 53 39 39 53 53 53 53 53 53 53 24 24 53 53 24 53 53 53 53 17 13 
53 3 3 3 12 12 13 53 54 58 54 53 53 53 53 18 18 18 53 54 54 54 53 53 28 28 9 9 28 28 2 24 62 62 62 62 62 62 62 62 62 62 62 62 62 62 52 56 56 62 62 62 62 62 62 62 62 62 62 62 62 62 62 62 62 53 53 22 51 53 53 53 53 3 3 53 53 56 53 53 53 39 53 53 53 53 53 53 53 53 53 45 53 53 53 17 17 53 17 13 
53 3 3 3 3 12 13 53 54 58 54 53 18 18 18 18 53 54 54 54 53 53 9 28 9 9 28 18 53 9 9 24 62 53 53 53 53 39 39 39 53 53 53 53 53 53 53 53 53 53 53 53 53 53 53 39 39 39 39 53 53 53 53 53 62 53 53 51 51 51 53 53 53 3 53 6 56 56 53 53 6 53 53 45 45 45 45 22 45 45 45 45 53 53 53 17 53 17 17 13 
53 3 3 10 3 12 13 54 54 58 54 53 18 53 53 54 54 54 53 53 53 9 28 9 9 28 18 22 53 9 9 24 62 53 53 53 45 45 53 53 53 53 53 17 53 53 53 53 53 45 45 45 45 53 53 30 30 53 53 53 53 39 39 2 62 53 14 51 51 51 53 53 53 53 53 52 52 52 52 52 52 6 53 14 45 45 45 22 45 45 45 53 53 53 53 17 17 17 53 53 
53 53 3 3 10 12 13 54 54 54 54 54 54 54 54 54 54 53 53 9 9 9 9 28 28 22 22 22 53 53 9 24 62 53 39 39 2 45 45 53 53 53 53 17 53 53 53 53 47 47 53 53 53 45 45 45 53 53 53 53 53 53 39 39 62 14 14 53 51 51 53 53 53 53 53 52 52 52 52 52 52 6 53 14 45 45 45 45 22 22 45 45 53 53 53 53 53 53 53 53 
53 53 3 10 10 10 13 53 53 53 53 54 54 54 54 54 53 53 9 28 9 53 28 18 22 22 22 53 53 9 9 24 62 53 39 30 53 53 45 45 47 17 47 47 47 47 53 53 52 52 52 52 52 52 52 53 53 53 53 53 53 53 53 39 62 53 14 53 53 51 53 53 53 53 53 52 53 52 56 56 52 6 6 14 45 45 45 14 45 22 22 45 45 45 45 53 53 53 53 53 
53 53 53 53 10 10 10 53 53 53 53 53 54 54 54 53 53 53 28 28 28 18 18 22 22 22 9 53 9 9 53 24 62 39 30 30 53 53 53 47 17 17 47 47 53 52 52 52 52 34 34 34 34 34 52 52 52 53 53 53 53 53 53 39 62 53 14 53 53 51 51 3 3 53 53 53 53 52 56 56 56 6 6 53 53 33 3 3 14 45 22 22 14 53 53 45 45 53 53 53 
53 53 53 53 10 53 10 10 53 53 53 53 53 54 58 54 54 53 53 28 28 18 22 47 22 22 22 53 9 53 53 24 62 30 30 53 53 53 17 17 53 47 47 47 47 52 37 47 53 53 53 53 53 53 53 35 52 52 52 53 53 53 53 53 62 53 14 14 53 53 51 53 53 3 3 53 53 52 52 53 53 53 53 53 53 53 33 3 3 45 45 22 22 22 53 53 53 53 53 53 
53 53 45 45 45 45 16 10 53 53 53 53 53 54 58 58 54 54 53 28 53 53 47 53 53 53 9 53 9 53 53 53 62 30 53 53 53 17 17 47 47 47 47 47 53 52 37 37 53 53 53 53 53 53 53 35 53 52 52 53 53 53 53 53 62 53 53 14 53 53 53 51 53 53 3 3 2 32 32 52 52 52 52 53 53 53 53 33 53 3 45 45 45 22 22 53 53 53 53 53 
53 53 45 16 45 45 45 53 45 53 53 53 54 54 4 58 54 54 53 47 53 53 47 47 47 53 9 47 9 47 53 47 62 53 53 53 53 53 52 52 52 52 52 52 52 52 52 37 53 53 53 53 53 53 53 35 52 52 53 53 53 53 53 53 62 53 53 53 14 53 14 14 51 51 53 53 3 32 53 32 32 53 53 53 53 53 53 53 53 53 53 45 45 45 22 14 14 53 53 53 
53 53 53 45 45 45 16 16 45 16 53 53 54 54 54 4 58 54 53 53 53 53 47 47 53 53 9 47 9 47 53 3 62 53 53 17 53 52 44 44 44 44 44 44 44 52 52 37 37 53 53 53 53 53 52 52 52 53 53 53 53 53 53 53 62 26 53 53 14 14 14 53 51 51 53 53 53 3 3 3 3 53 53 53 53 53 53 22 22 22 22 53 45 14 45 22 22 53 14 14 
53 53 45 45 45 45 16 16 45 16 16 53 53 53 53 4 58 58 53 53 53 53 47 47 53 53 9 9 47 47 53 53 5 5 53 17 53 52 53 53 47 47 53 47 47 53 52 52 53 53 47 53 52 52 52 53 53 53 53 53 53 53 53 53 53 5 53 53 53 53 52 52 51 53 53 3 3 53 53 53 53 53 53 53 53 53 53 22 53 53 53 22 22 45 45 45 22 22 14 14 
53 45 45 45 45 45 51 16 10 53 53 16 10 53 53 53 4 4 53 53 53 53 53 53 53 53 47 9 47 52 52 5 47 5 5 17 53 52 1 53 47 22 22 22 47 53 52 52 52 52 52 45 52 53 52 52 52 52 52 52 52 52 52 53 53 5 53 53 52 52 52 53 53 53 51 51 51 53 53 51 53 51 51 51 51 51 53 53 22 22 22 22 22 53 53 14 14 14 14 14 
45 45 45 45 51 51 51 45 45 10 10 16 53 53 53 53 4 4 4 53 53 53 47 53 53 47 47 52 52 47 47 47 47 53 17 17 53 52 1 47 47 22 22 22 47 53 52 52 52 47 47 45 47 52 47 53 53 53 53 53 53 53 52 52 62 7 5 52 53 53 53 53 53 53 53 53 51 51 51 53 53 53 51 53 53 51 51 51 53 22 53 53 53 53 14 14 14 14 14 53 
45 45 45 51 51 16 45 45 45 45 16 16 16 16 53 53 53 4 4 4 53 47 53 53 52 52 52 47 47 47 53 3 62 53 17 53 53 52 1 2 53 53 53 53 53 52 52 53 47 47 45 45 47 52 47 47 53 53 53 53 53 53 53 53 62 52 52 53 53 53 53 53 53 53 51 51 53 51 51 51 51 51 51 51 51 51 53 53 51 53 53 53 53 53 14 14 14 14 14 13 
45 45 51 51 45 45 16 16 45 45 45 10 10 10 53 53 53 4 4 4 53 53 52 52 52 47 47 47 53 53 53 53 62 53 17 53 6 30 30 30 30 30 30 30 52 52 53 53 53 45 45 47 47 52 47 47 53 53 53 53 53 53 53 53 62 52 53 53 53 53 53 53 51 51 51 51 51 53 53 51 51 51 53 53 53 53 53 53 53 51 53 53 53 14 14 14 14 14 13 13 
53 51 51 45 45 45 45 45 45 45 45 53 10 10 53 53 53 64 64 64 47 52 52 47 47 47 53 53 53 53 53 53 62 53 53 53 6 6 6 6 6 6 6 6 52 53 47 47 47 45 45 47 53 52 53 53 53 53 16 16 53 53 53 53 62 53 53 53 53 53 53 53 51 51 53 53 53 53 53 53 53 53 53 53 63 63 63 63 53 51 53 53 53 14 14 14 14 14 13 13 
53 45 45 45 45 45 37 37 45 45 53 53 53 10 53 53 53 64 64 64 47 53 47 47 53 53 47 53 53 53 53 53 62 53 53 53 53 53 53 41 41 41 47 40 52 53 53 53 53 47 47 47 47 52 53 53 53 16 16 16 53 53 53 37 62 53 53 53 53 53 53 53 51 51 51 53 53 51 51 51 51 51 53 53 53 63 53 53 63 63 51 14 14 14 14 14 13 13 13 53 
2 45 45 45 45 53 53 53 53 52 52 52 52 53 53 53 53 54 54 54 47 53 53 47 47 52 52 53 53 53 53 53 62 53 51 51 51 51 53 53 53 53 47 40 52 47 47 32 32 32 32 32 47 52 52 47 53 16 16 16 53 53 53 37 62 53 53 53 53 53 53 51 53 53 53 53 53 53 53 53 53 51 51 51 51 51 53 53 53 53 51 14 14 14 13 13 13 13 13 53 
53 53 53 53 53 53 53 51 53 53 53 53 52 52 52 53 53 54 54 54 14 47 53 47 47 47 52 53 53 53 53 53 62 32 53 53 53 51 51 53 53 53 53 40 52 52 32 30 29 30 32 52 53 53 52 53 53 53 53 53 53 53 52 37 62 53 53 53 51 53 53 51 53 53 53 51 51 53 53 51 51 53 53 51 51 51 51 53 53 53 53 51 13 13 13 13 13 13 53 54 
53 53 53 53 45 45 53 51 51 51 53 57 57 57 52 52 53 54 48 54 14 47 53 47 47 53 52 52 52 53 53 53 62 32 53 53 53 53 51 51 53 53 53 53 53 52 52 52 52 47 47 52 52 53 52 53 53 53 53 53 53 53 53 52 62 53 51 51 53 53 51 51 53 53 51 51 51 53 51 63 63 53 53 51 51 51 51 51 51 51 51 51 13 13 13 13 13 53 54 54 
53 53 53 53 51 51 51 51 51 51 51 60 60 60 57 57 53 53 48 54 14 14 53 47 47 52 52 53 53 53 53 53 62 32 32 53 53 53 53 51 51 53 53 53 53 47 47 47 52 52 53 53 52 53 52 52 53 53 53 53 53 2 53 53 62 53 53 53 53 53 51 53 53 51 51 53 53 53 63 63 63 53 53 63 63 53 63 53 53 53 53 53 53 53 13 13 54 54 54 54 
53 53 53 53 51 51 51 51 51 51 51 51 51 60 53 57 53 53 48 54 14 14 14 53 52 53 31 31 41 31 53 53 62 5 43 32 43 43 43 43 51 51 5 5 5 5 5 5 53 52 53 53 52 53 53 53 53 53 44 44 44 53 53 53 62 51 53 53 53 51 51 53 51 51 53 53 63 63 53 51 53 63 63 63 63 63 53 53 53 53 53 53 53 53 54 54 54 54 54 54 
53 53 53 53 51 51 51 53 60 60 60 60 51 51 53 57 53 53 48 54 53 14 14 53 53 53 36 53 53 38 53 53 62 62 62 62 62 62 62 62 62 62 62 62 62 62 62 5 5 5 62 62 62 62 62 62 62 62 62 62 62 62 62 62 62 53 53 53 53 51 53 51 53 53 53 53 51 51 51 63 63 63 63 16 53 53 53 53 53 53 54 54 54 54 54 54 54 54 54 54 
53 53 53 53 51 45 53 53 57 57 57 57 60 52 52 52 53 53 48 48 53 14 14 53 53 53 36 53 53 38 53 2 3 53 53 53 53 3 3 3 53 53 53 53 53 53 7 52 52 52 7 53 53 53 53 53 53 53 53 53 53 53 53 51 53 53 53 51 51 51 51 51 53 51 51 51 51 53 63 53 53 63 16 16 53 53 17 53 53 54 54 58 58 58 54 58 54 54 54 54 
53 53 53 53 51 51 53 53 53 53 57 57 52 60 60 53 53 53 48 48 53 14 14 14 53 53 36 34 34 38 3 3 52 53 53 3 3 3 3 3 3 3 3 57 57 57 57 52 52 52 53 53 53 53 53 53 51 51 51 53 53 53 51 51 53 51 51 51 51 51 53 53 53 51 53 53 63 63 16 16 16 16 53 17 17 17 17 53 54 54 54 58 58 58 58 58 54 54 54 13 
53 53 37 37 53 51 51 51 35 53 44 35 35 60 40 53 53 53 48 48 53 14 14 14 53 57 57 53 53 3 3 52 53 22 22 22 53 22 14 11 57 57 57 57 57 57 57 57 52 53 52 53 53 53 17 17 14 14 57 51 51 51 51 51 51 51 51 51 51 16 51 53 51 53 53 16 16 16 16 17 17 17 17 17 53 54 54 54 54 54 58 58 58 58 58 54 54 54 13 13 
53 45 45 53 53 51 51 53 53 53 57 53 53 53 53 53 53 53 48 48 54 53 14 14 14 53 53 57 3 3 52 14 22 22 57 11 11 14 57 11 11 57 57 57 57 57 45 57 52 52 52 52 53 53 53 53 17 14 14 57 57 51 51 51 51 53 51 51 51 51 16 16 16 17 16 16 16 17 17 17 17 17 54 54 54 54 54 54 54 58 58 58 58 54 54 54 54 13 13 13 
45 45 53 45 45 51 51 45 51 51 51 45 53 53 53 53 53 53 53 54 54 54 53 14 14 57 57 3 3 57 22 22 45 57 22 22 11 11 11 57 11 11 11 53 53 57 57 45 52 52 52 52 57 57 53 57 57 17 17 14 14 57 53 53 51 16 51 16 16 16 16 16 16 16 16 17 53 53 54 54 54 54 54 54 54 54 54 54 54 54 54 54 54 54 54 54 13 13 16 12 
53 45 45 53 51 45 45 45 51 2 53 53 51 51 45 53 53 53 53 53 54 54 54 53 14 14 57 57 22 22 14 14 22 45 14 14 14 14 11 11 11 57 11 11 57 45 53 53 45 52 52 52 52 57 57 57 53 53 17 53 14 14 57 53 16 16 16 16 16 16 16 16 53 16 53 53 54 54 54 54 54 54 54 54 54 54 54 54 54 54 54 54 54 54 13 13 13 9 12 12 
53 53 45 45 45 45 45 45 51 51 45 53 53 51 51 51 53 53 53 53 54 54 54 54 14 14 53 53 22 53 53 45 45 45 45 3 3 3 57 57 2 11 57 45 45 45 45 53 45 45 57 52 52 52 57 57 57 57 57 17 17 57 16 16 16 16 16 16 16 16 16 53 54 54 54 54 54 54 54 54 54 54 54 54 54 54 54 54 54 54 12 12 12 13 13 9 16 16 12 12 
53 51 51 45 45 45 45 51 53 51 51 24 24 3 3 51 51 51 51 53 53 54 54 54 14 14 14 53 53 14 53 53 53 53 53 45 3 53 53 53 57 57 57 45 45 45 57 53 53 45 57 57 52 52 52 53 53 53 53 16 16 16 16 53 54 54 54 54 54 4 54 54 54 54 54 54 54 54 54 15 18 18 18 18 18 18 9 9 18 18 12 12 12 12 13 12 12 12 12 12 
53 51 45 53 53 45 53 51 45 3 3 3 3 3 3 53 3 3 3 53 53 53 54 54 54 54 14 14 14 14 14 14 14 14 53 57 3 57 57 57 53 53 53 53 45 45 57 53 53 53 57 53 53 52 52 53 53 53 53 53 54 54 54 54 54 54 4 58 4 54 54 54 54 54 54 17 17 9 15 18 9 9 9 9 9 9 18 18 18 9 12 9 12 12 13 12 12 12 12 12 
57 57 45 53 45 45 45 45 53 53 53 3 3 3 3 51 53 51 3 53 53 53 54 54 54 54 54 53 14 14 53 53 53 53 14 14 14 14 14 2 18 18 57 53 53 53 53 53 53 53 53 53 53 20 20 53 53 54 54 54 54 58 58 58 58 58 58 58 58 54 54 54 54 17 17 17 15 15 9 18 9 9 9 9 9 9 9 16 16 12 12 16 9 9 12 12 12 12 12 12 
57 57 53 45 45 45 53 53 53 53 53 3 3 3 3 53 53 53 53 53 53 53 53 54 54 54 54 54 53 14 14 14 14 53 53 53 53 53 53 53 53 53 53 57 53 53 53 53 53 53 54 54 54 20 20 54 54 58 58 58 58 58 58 58 58 58 58 58 54 54 54 54 54 15 15 15 15 9 9 9 9 9 9 9 9 16 16 12 12 12 9 9 9 16 12 12 12 12 12 12 
53 45 57 45 39 39 39 53 53 57 57 53 53 53 53 53 53 53 53 53 53 53 53 53 53 54 54 54 54 54 54 54 54 54 54 54 54 54 54 54 54 54 54 54 54 54 54 54 54 54 54 54 54 20 20 54 54 54 58 58 58 58 58 58 58 58 54 54 54 54 54 15 15 15 9 9 9 9 9 9 9 9 9 9 16 16 12 12 57 57 9 9 9 16 12 12 12 12 12 12 
57 45 45 45 57 53 53 53 57 57 53 53 53 53 53 53 53 53 53 53 53 54 54 54 54 54 58 58 58 58 58 58 58 54 54 54 54 54 58 58 54 54 58 54 54 54 54 54 54 54 54 54 54 20 20 54 54 54 54 54 54 54 54 54 54 54 54 54 54 54 54 15 15 15 9 9 9 9 9 9 9 9 9 16 16 9 11 11 57 57 11 11 9 9 9 12 12 12 12 12 
57 45 45 45 3 57 53 57 57 57 57 53 53 53 53 53 53 53 53 20 20 54 54 54 54 54 54 54 54 54 54 54 54 54 54 54 58 58 58 58 58 58 58 58 58 54 54 54 54 20 20 20 54 20 20 54 54 54 54 54 54 54 54 54 54 54 54 54 54 54 59 15 15 14 14 59 9 9 9 9 9 9 16 9 9 11 11 57 57 57 53 12 11 9 12 12 12 12 12 55 
57 45 45 45 3 3 57 57 57 57 53 53 53 53 53 53 53 53 54 20 20 54 53 53 53 53 53 53 53 53 54 54 54 54 54 54 54 54 58 54 54 58 54 54 54 20 20 20 20 34 34 34 53 20 20 53 53 53 53 53 53 53 53 53 53 54 54 54 54 54 54 14 14 15 15 14 15 9 9 9 9 9 9 9 9 57 57 57 57 12 53 9 11 11 12 12 12 9 12 12 
53 45 53 45 45 3 57 57 57 53 31 31 31 31 53 53 54 54 54 20 20 54 53 34 53 53 53 53 53 53 53 53 53 53 54 54 54 54 54 54 54 54 54 54 53 34 34 34 34 53 53 53 6 6 6 53 53 53 51 53 53 53 53 53 53 53 53 54 54 54 54 54 54 14 14 14 9 14 9 9 9 9 9 57 57 57 57 57 57 57 57 12 9 9 12 9 12 12 12 12 
57 45 57 45 57 3 3 57 53 53 31 53 53 54 54 54 54 54 4 56 56 56 56 34 34 53 53 53 53 53 53 53 53 53 53 53 53 53 53 53 53 54 54 54 53 53 53 53 53 53 53 53 6 6 53 53 53 51 51 53 53 53 53 53 53 53 53 53 53 54 54 54 54 54 54 14 14 14 14 14 9 9 9 57 57 57 57 57 57 57 57 12 9 9 12 12 12 12 12 12 
57 45 57 45 57 3 3 53 53 31 31 53 54 54 54 54 48 54 22 52 52 52 52 52 34 34 34 53 53 53 53 53 53 53 53 53 53 53 53 53 53 53 53 53 53 53 53 53 53 53 53 53 6 6 53 53 53 51 53 53 56 56 56 56 53 53 53 53 14 14 14 54 54 54 54 54 14 14 14 14 14 9 9 9 9 9 11 57 57 53 53 12 11 11 11 12 11 12 12 12 
57 45 57 57 57 3 3 45 53 53 54 54 54 54 54 54 48 54 22 22 28 52 52 52 52 52 52 53 53 53 53 53 53 53 53 53 53 53 53 51 53 53 53 53 53 53 53 53 53 53 53 53 6 6 53 53 51 51 27 27 27 27 53 56 56 56 53 53 14 14 14 14 14 54 54 54 54 54 54 14 14 14 14 9 9 9 9 11 57 53 14 11 11 11 9 55 11 12 12 12 
57 45 57 45 45 45 3 45 54 54 54 58 58 54 54 54 48 54 53 22 28 28 28 52 52 52 52 52 52 52 56 2 38 38 38 38 38 53 53 51 51 51 51 51 53 53 53 53 53 53 53 53 6 6 53 53 51 51 51 53 53 53 53 53 53 53 56 53 14 14 61 14 14 14 54 54 54 54 54 14 14 14 14 14 14 9 9 9 57 53 12 12 14 11 11 12 55 9 9 12 
53 53 53 57 53 53 53 54 54 54 58 54 54 54 15 15 54 54 53 53 22 22 14 14 14 53 52 52 52 52 52 52 52 56 56 53 38 38 53 53 51 51 36 51 51 53 53 53 53 53 53 6 6 53 53 51 51 51 51 53 53 51 51 51 53 53 53 53 53 14 14 14 14 14 14 14 54 54 54 54 14 14 14 14 9 9 9 9 57 53 14 14 9 14 14 12 12 9 12 55 
53 53 53 53 53 4 54 54 58 54 54 54 54 15 15 15 54 54 53 53 53 22 51 14 51 31 31 31 31 53 52 52 52 52 52 52 56 53 14 14 53 51 51 51 51 51 51 53 53 53 53 6 6 53 53 51 51 51 51 51 51 53 53 53 51 51 51 53 53 53 53 14 14 14 14 14 14 54 54 54 54 54 54 14 14 14 14 14 14 14 14 14 14 14 11 14 14 12 12 55 
53 53 48 48 48 54 54 54 54 54 15 15 15 15 15 15 54 54 54 53 53 22 22 51 2 53 53 53 31 53 53 38 52 52 52 52 52 56 56 14 14 51 51 51 51 51 51 51 53 53 53 6 6 53 53 51 51 51 53 57 53 53 53 51 51 51 53 53 53 56 53 53 53 53 14 14 14 14 53 54 54 54 54 54 54 54 54 14 14 9 14 14 9 14 14 14 14 14 9 9 
53 48 48 54 54 58 54 54 54 15 17 17 14 14 14 15 54 48 54 53 22 22 22 22 51 51 53 53 53 24 24 53 38 38 53 52 52 52 52 52 14 53 53 53 51 51 51 53 53 53 56 56 56 53 51 51 51 53 53 57 53 53 24 24 2 51 53 53 56 56 53 53 53 53 53 14 14 14 14 53 54 48 54 54 54 54 54 54 54 14 14 14 14 14 14 14 14 14 9 9 
48 48 54 54 54 54 54 54 15 15 11 11 11 14 14 15 54 4 54 53 22 22 22 22 60 51 51 53 53 53 24 24 24 53 44 44 44 52 52 52 52 52 53 53 32 53 53 53 32 53 56 56 53 53 51 51 53 2 51 53 57 57 24 24 51 51 53 56 56 53 53 53 53 53 53 53 53 14 14 53 53 53 54 48 48 48 48 54 54 54 14 14 14 14 14 14 14 14 14 14 
54 54 54 54 54 54 15 15 17 11 11 11 11 11 14 15 54 54 54 53 22 22 22 22 60 60 51 51 51 57 57 57 57 24 24 60 60 60 56 52 52 52 52 53 53 32 32 32 53 56 56 56 53 53 53 51 51 51 51 51 53 57 53 53 53 51 53 56 53 53 53 53 53 53 24 24 53 14 14 53 14 14 14 53 53 53 48 48 48 58 54 54 54 54 54 48 48 14 14 14 
54 54 54 15 15 15 15 17 15 15 11 11 11 11 14 54 54 54 48 53 22 22 22 57 57 60 60 51 51 51 51 51 57 57 57 24 60 34 34 34 52 52 52 52 30 30 30 30 30 56 56 53 53 53 53 51 51 51 51 51 53 24 57 57 53 53 56 56 61 61 53 53 53 53 24 24 24 59 14 14 14 53 14 14 53 53 53 53 48 48 58 58 58 58 54 54 54 54 48 53 
16 16 15 15 15 15 17 15 17 17 15 11 11 11 11 54 48 54 48 53 22 22 22 57 57 60 60 60 51 51 51 51 51 51 57 57 24 53 53 34 56 56 52 52 52 53 53 53 56 56 56 53 53 53 51 51 51 51 53 53 24 24 24 57 53 61 61 61 15 51 51 51 53 53 53 59 24 24 61 14 53 53 53 53 53 54 54 54 54 48 48 48 54 58 48 48 54 54 54 54 
16 16 16 16 16 16 16 15 15 17 17 17 11 11 11 17 48 58 58 53 22 22 22 57 57 57 57 57 51 51 51 51 51 51 51 57 57 57 53 34 34 34 56 56 52 52 53 53 56 56 56 53 53 53 51 51 51 51 53 53 24 53 57 57 61 61 53 53 15 53 51 51 51 15 15 15 59 24 24 53 53 53 53 53 53 53 19 19 19 19 19 19 19 19 48 58 58 58 54 54 
51 16 16 16 16 16 16 16 15 28 17 17 17 15 17 17 48 58 48 53 22 57 57 57 57 51 51 51 51 53 53 51 51 51 51 51 51 57 57 53 53 53 62 62 56 52 56 56 56 56 53 53 53 51 51 51 51 51 53 24 24 53 57 53 51 51 15 53 15 15 15 51 51 51 15 53 24 24 53 24 24 57 53 56 56 56 8 8 8 8 8 8 8 8 54 54 54 58 58 58 
51 51 16 16 16 22 28 28 28 28 15 17 9 17 17 48 58 58 48 53 22 22 57 57 51 22 22 51 51 51 51 51 51 51 22 22 51 51 57 53 17 17 17 62 52 52 52 56 56 56 53 53 53 51 51 51 51 53 53 53 53 53 53 53 53 51 51 15 15 15 15 15 51 53 53 57 60 53 55 24 57 53 53 53 53 53 6 6 6 6 6 53 53 17 17 17 17 53 53 53 
51 51 51 16 22 22 16 16 28 28 28 9 9 17 17 48 4 54 48 22 22 51 22 22 22 22 51 51 51 51 51 51 22 22 22 22 22 51 51 11 15 15 17 62 62 52 52 52 56 53 53 53 53 51 51 51 53 57 57 63 63 53 53 53 53 15 15 51 15 15 53 53 51 53 60 60 53 60 57 55 53 6 6 6 6 6 6 53 53 53 53 17 17 17 22 22 22 22 22 22 
51 51 51 45 22 16 16 16 16 16 16 28 28 9 11 4 54 54 48 51 22 22 22 22 53 53 51 53 51 51 51 22 22 51 22 22 22 22 22 53 11 15 15 17 62 52 56 52 56 53 53 53 51 51 51 51 53 53 53 53 53 60 60 53 15 15 15 53 51 51 53 53 51 60 60 60 60 53 53 6 6 6 6 6 53 53 53 17 17 17 17 22 22 22 22 22 53 22 22 53 
51 51 51 22 45 51 16 16 16 16 16 16 16 28 28 4 54 4 6 52 52 6 22 22 41 53 51 53 53 51 22 22 22 22 51 22 22 22 22 22 53 11 15 15 62 52 56 56 53 53 53 53 51 51 51 51 63 63 63 60 60 60 57 15 17 53 53 15 15 51 51 53 60 60 60 60 6 6 6 6 6 6 53 53 17 17 17 17 22 22 53 53 53 53 53 53 53 53 53 53 
51 51 22 22 45 45 45 51 16 16 18 16 16 28 28 28 4 4 6 52 52 52 52 52 6 2 33 33 33 53 22 22 51 51 22 22 22 22 13 13 53 11 17 17 62 56 56 56 53 53 53 51 53 51 51 63 63 53 60 53 57 15 17 17 53 22 22 57 57 53 53 51 51 53 6 6 6 6 6 53 57 53 17 17 17 13 22 13 45 45 45 45 45 45 45 45 53 53 53 53 
51 51 51 51 51 51 45 51 51 16 16 18 16 16 16 4 58 58 51 51 39 6 6 52 52 52 6 6 34 34 53 22 22 22 51 22 22 13 13 13 45 45 45 45 56 56 56 53 53 53 53 51 63 63 63 63 53 53 51 17 17 17 17 22 22 22 53 57 53 53 6 6 53 53 53 6 6 53 57 57 17 17 17 13 13 13 45 45 45 45 45 45 45 45 53 53 53 53 51 51 
45 45 51 51 51 51 51 51 51 51 51 16 18 18 10 54 54 48 51 51 45 39 39 52 6 52 52 52 52 52 36 34 51 22 51 51 51 53 13 13 45 45 45 45 56 52 52 53 53 53 51 51 63 51 51 51 17 17 22 22 17 22 22 53 53 53 6 53 6 6 6 6 6 6 53 57 57 57 17 17 17 13 13 45 45 45 45 45 45 45 45 53 53 51 51 51 51 51 53 53 
45 45 51 51 51 51 51 51 51 45 51 51 16 18 54 54 54 48 53 53 45 53 18 52 12 13 53 6 6 52 52 6 36 36 53 33 33 53 13 45 45 45 45 56 52 52 56 53 53 53 51 51 51 51 51 17 22 22 22 22 22 22 53 53 6 6 6 6 6 6 6 6 53 53 13 13 13 13 17 13 13 13 18 45 45 45 45 45 45 51 51 51 51 51 51 51 51 53 53 53 
45 45 45 51 51 51 51 51 51 51 51 51 51 51 54 54 58 48 53 45 45 45 45 2 13 53 39 39 39 53 52 52 6 52 6 6 6 6 26 45 45 45 45 56 52 56 56 53 53 53 53 51 51 17 22 22 22 22 22 22 53 53 6 6 6 6 6 6 6 53 57 57 13 13 13 13 13 13 13 13 13 13 18 45 45 45 45 51 51 22 51 51 51 51 51 53 53 53 53 53 
45 45 45 60 60 3 3 3 3 51 51 51 51 51 54 4 58 48 53 53 53 53 45 45 45 45 53 53 51 52 6 6 52 52 6 6 52 6 6 6 6 52 6 56 56 56 56 56 53 53 53 53 53 22 22 22 22 53 53 53 6 6 6 6 6 53 53 57 57 57 57 13 13 13 13 13 13 18 18 18 45 45 45 45 45 51 51 22 22 51 51 51 53 53 53 53 53 53 53 53 
45 45 45 60 45 45 3 3 3 35 32 32 32 32 48 58 58 48 53 11 53 53 45 53 53 53 51 51 51 52 53 53 6 52 52 52 52 52 52 52 52 52 6 6 56 56 56 53 53 53 53 53 53 53 53 53 53 6 6 6 6 6 6 53 53 53 53 53 53 11 11 13 13 13 13 18 18 18 18 18 18 53 53 53 51 22 22 51 51 51 51 51 53 34 34 53 53 53 53 53 
45 45 57 5 45 45 53 53 3 35 53 53 46 46 4 58 48 48 11 11 53 45 45 51 53 53 51 52 52 52 51 51 53 34 34 34 34 34 34 6 6 6 6 6 6 6 6 53 53 53 53 6 6 6 6 6 6 6 6 6 53 37 35 35 47 47 11 11 11 11 13 13 53 16 16 18 18 18 18 53 53 53 51 51 22 22 51 51 51 51 51 53 53 53 53 53 53 53 53 53 
45 45 57 57 57 5 5 53 3 35 53 53 46 46 4 4 48 11 11 45 45 53 51 51 53 53 51 52 52 11 11 51 45 45 45 45 45 53 34 34 34 34 34 53 6 6 6 53 6 6 6 6 6 6 6 6 6 53 6 53 53 24 24 53 47 11 11 11 11 11 11 53 53 53 53 16 16 18 18 18 51 51 22 22 22 51 51 51 51 51 51 53 53 53 53 53 53 53 53 53 
45 45 53 57 57 57 5 5 45 35 53 53 46 46 54 54 53 11 45 45 53 63 51 51 51 17 52 52 11 11 53 53 51 53 53 53 45 45 45 53 53 53 53 45 53 6 6 53 6 6 6 6 6 53 53 53 53 53 24 24 47 24 24 24 47 11 11 11 53 53 53 53 53 53 53 53 22 22 16 16 51 22 22 51 51 51 51 51 53 53 51 53 53 53 53 53 53 53 53 53 
45 45 45 45 45 45 53 53 53 53 53 46 46 54 54 54 11 45 45 63 63 63 51 51 17 53 52 52 35 53 45 53 53 51 53 51 51 53 45 45 45 45 45 45 53 6 6 53 6 6 53 53 53 53 17 17 53 17 53 11 47 47 24 24 24 24 53 53 53 53 53 53 53 22 22 22 53 53 51 51 22 51 51 51 51 51 53 53 53 53 51 53 53 53 53 53 53 53 53 53 
53 53 45 45 3 3 3 3 53 53 53 46 53 54 54 11 53 53 63 63 51 51 51 17 53 52 52 35 35 35 17 45 53 53 51 53 53 53 51 51 53 53 45 45 53 6 6 6 6 53 53 53 17 17 53 17 17 17 11 28 11 53 47 24 24 24 24 53 53 53 22 22 53 53 53 53 53 53 53 51 51 51 51 51 53 53 32 32 53 16 16 51 53 53 53 53 53 53 53 53 
53 53 53 51 3 3 3 53 63 63 63 53 54 54 11 11 45 45 63 63 51 51 17 17 53 52 52 35 16 17 17 45 45 53 51 51 53 53 53 53 51 51 53 45 45 45 6 6 6 53 17 17 17 53 17 17 53 53 53 28 28 28 53 53 24 24 53 53 53 53 53 53 53 53 53 53 53 51 2 51 51 51 51 53 53 53 53 16 16 16 51 51 51 51 51 53 53 53 53 53 
53 53 15 51 3 3 63 63 63 63 53 53 54 54 53 53 45 63 63 51 51 17 17 2 52 52 35 10 10 10 16 16 45 45 53 53 51 51 53 53 53 51 45 45 51 62 6 6 62 17 17 53 17 17 17 17 13 53 53 53 28 28 28 53 53 53 53 53 53 53 53 53 53 53 53 53 51 53 51 51 16 16 16 16 16 16 16 53 53 53 53 53 53 53 53 53 53 53 53 53 
53 15 51 3 3 63 63 63 63 63 63 54 54 54 53 53 63 63 51 51 51 51 52 52 52 52 35 10 10 10 10 16 16 45 45 45 53 51 51 51 53 51 53 53 51 62 6 6 62 17 17 17 17 17 53 2 13 5 53 53 28 28 28 28 53 53 53 53 53 53 53 53 53 53 53 53 51 51 51 51 51 53 53 53 53 53 53 53 53 53 53 53 53 53 53 53 53 53 53 53 
15 51 51 3 63 63 63 63 63 63 53 54 54 53 53 53 63 51 51 51 51 51 52 52 52 2 53 10 10 10 10 10 16 16 45 45 45 45 53 53 53 51 51 51 51 49 6 6 17 17 17 17 17 17 53 53 5 5 53 53 53 53 53 53 53 53 53 53 53 53 53 53 53 53 51 51 51 51 51 51 53 53 53 53 53 53 53 53 53 53 53 53 53 53 53 53 53 53 53 53 
